1111111111111111
1P00000000001C01
1000000C00001001
1000000000001001
100C0000000010C1
1000100000000001
1C00100C000C0E01
1111111111111111