1111111111111111
1P000000X0001C01
1000000C00001001
1000000000001001
100C0X00000010C1
1000100000000X01
1100100000010001
1100100C00010001
1C101000X0010001
1000100000010001
11001000X0010101
1000100000010111
1C00100C00X100E1
1111111111111111