1111111111111111
1P00000000001C01
1000000C00001001
1000000000001001
100C0000000010C1
1000100000000001
1100100000010001
1000100C00010001
1C00100000010001
1000100000010001
1100100000010101
1000100000010101
1C00100C00010CE1
1111111111111111