1111111111111111
1P00X000X0001CX1
1000000C00001001
1000000000001001
100C0000000010C1
1000100000000X01
11001000X0010001
1100100C0X010001
1C10100000010001
1000100000010001
1100100000010101
1X00100000010111
1C0X100C000100E1
1111111111111111