11111111
1P00C0C1
11111101
10000CE1
11111111