11111111
1P00C0C1
11111111
100000E1
11111111